NO ./path_to_the_north_texture
SO ./path_to_the_south_texture
WE ./path_to_the_west_texture

EA ./path_to_the_east_texture

       F 220, 12,0
             C 225,   3 ,   1

        111111111  1111111111111
        11111111111111111111111111
        100000000011000000000001
        1011000001110000000000001
        10010000000000000000000011111111111
         11111111111011000001110000000000001
           100000000011000001110111111111111
           11110111111111011100000010001
           11110110000011011101010010001
           11000000000E01011100000010001
           10000000000000001100000010001
           1000000000000000110101010001
           11000001110101011101111000111
           11110111 1110101 101111010001
           11111111 1111111 111111111111