C 1, 1, 1
F 1, 1, 1

EA textures/e.png
WE textures/e.png
SO textures/e.png
NO textures/e.png

1111111111111111111111111111111111111111
11N000000000000000000000000111111111111111111111
100000000000000000000000000000000000000001
100000000000000000000000000000000000000001
100000000000000000000000000000000000000001
100000000000000000000000000000000000000001
100000000000000000000000000000000000000001
100000000000000000000000000000000000000001
111111111111111111111111111111111111111111

