C 135, 206,235
F 139,90,43

NO assets/zlij1.png
WE assets/zlij2.png
SO assets/zlij3.png
EA assets/zlij4.png

111111111111111111111
1N0000000000000000111
1110000000000000000111
1000000000000000000011
1000000000000000001001
1111000000000000000011
1110000000000000000111
1100000000000000001111
11111111111111111111111