C 135, 206,235
F 139,90,43

EA assets/1.png
WE assets/1.png
SO assets/1.png
NO assets/1.png

11111111
1N001111
11100111
11110011
11111001
11110011
11100111
11001111
11111111