C 47, 161, 228
F 255,1, 1

EA textures/1.png
WE textures/1.png
SO textures/1.png
NO textures/1.png

                     1111111111111111111111111111111111111111
 111111111111111111111111111S000000000000000000000000111111111111111111111
                     1000000000000000000000000000000000000000011111111111111111111111111
                     100000000000000000000000000000000000000001
                     100000000000000000000000000000000000000001
                     100000000000000000000000000000000000000001
                     100000000000000000000000000000000000000001
                     100000000000000000000000000000000000000001
                     111111111111111111111111111111111111111111

