C 1, 1, 1
F 1, 1, 1

EA textures/path_to_the_east_texture
WE textures/path_to_the_west_texture
SO textures/path_to_the_south_texture
NO textures/path_to_the_north_texture

                            1  11111111111
                                  11N011111111
                            111111111111
