C 135, 206,235
F 139,90,43

NO assets/zlij1.png
WE assets/zlij2.png
SO assets/zlij3.png
EA assets/zlij4.png

1111111
1N00111
11100111
11110011
11111001
11110011
11100111
11001111
11111111