C 1, 1, 1
F 1, 1, 1

EA  path_to_the_east_texture
WE  path_to_the_west_texture
SO path_to_the_south_texture
NO path_to_the_north_texture


 1
11111111111

10000N1111111111
1111111111111111