C 135, 206,235
F 139,90,43

 EA  assets/g.png
WE assets/r.png
SO assets/g.png
NO assets/r.png

                     1111111111111111111111111111111111111111
 111111111111111111111111111S000000000000000000000000111111111111111111111
                     100000000000000000000000000000000000000011111111111111111111111111
                     100000000000000000000000000000000000000001
                     100000000000000000000000000000000000000001
                     100000000000000000110000000000000000000001
                     100000000000000000000000000000000000000001
                     100000000000000000000000000000000000000001
                     111111111111111111111111111111111111111111

