C 1, 1, 1
F 1, 1, 1

EA  path_to_the_east_texture
WE  path_to_the_west_texture
SO path_to_the_south_texture
NO path_to_the_north_texture

111111111111
110000N00011
110000000011
111111111111