C 135, 206,235
NO assets/1.png
F 139,90,43

WE assets/1.png
SO assets/1.png
EA assets/1.png


1111111111111111111
1000000000000000001
1000000000000000001
1000000000000000001
100000000001D100001
1000000000000000001
10000000000N0000001
1000000000000000001
1000000000000000001
1000000000000000001
1111111111111111111