C 135, 206,235
F 139,90,43

EA assets/1.png
WE assets/1.png
SO assets/1.png
NO assets/1.png 

                     1111111111111111111111111111111111111111
 111111111111111111111111111S000000000000000000000000111111111111111111111
                     100000000000000000000000000000000000000011111111111111111111111111
                     100000000000000000000000000000000000000001
                     100000000000000000000100000000000000000001
                     100000000000000000001D1D101000000000000001
                     100000000000000000000100000000000000000001
                     100000000000000000000000000000000000000001
                     111111111111111111111111111111111111111111