C 135, 206,235
F 139,90,43

NO assets/white.png
WE assets/green.png
SO assets/black.png
EA assets/red.png


1111111111111111111111111111
1000000000000000000000000001
1000000000000000000000000001
1000000000000000000000000001
1000000000000000000000000001
1000000000000000000000000001
1000000000000000000000000001
1000000000000000000000000001
1000000000000000000000000001
1000000000000000000000000001
1000000000000000000000000001
1000000000000000000000000001
1000000000000000000000000001
10000000000000N0000000000001
1000000000000000000000000001
1000000000000000000000000001
1000000000000000000000000001
1000000000000000000000000001
1000000000000000000000000001
11111D1110000000000000000001
1000000010000000000000000001
10000000D0000000000000000001
1000000010000000000000000001
1111111111111111111111111111
