C 1, 1, 1
F 1, 1, 1

EA assets/1.png
WE assets/1.png
SO assets/1.png
NO assets/1.png

111111111111
110000ED0001
110000100011
111111111111