C 135, 206,235
F 157, 110, 94

NO assets/wall.png
WE assets/wall_1.png
EA assets/wall_3.png
SO assets/wall_2.png


1111111111111111111111111111
1000000000000000000000000001
1000000000000000000000000001
1000000000000000000000000001
1000000000000000000000000001
1000000000000000000000000001
1000000000000000000000000001
1000000000000000000000000001
1000000000000000000000000001
1000000000000000000000000001
1000000000000000000000000001
1000000000000000000000000001
1000000000000000000000000001
10000000000000N0000000000001
1000000000000000000000000001
1000000000000000000000000001
1000000000000000000000000001
1000000000000000000000000001
1000000000000000000000000001
11111D1110000000000000000001
1000000010000000000000000001
10000000D0000000000000000001
10000000100001111111000000001
1111111111111111111111111111
